111111
11C111
10E011
1P0011
111111