111111111111111
10000100C0000C1
10E00100C000001
100001C0000P001
111111111110001
1000000C0000001
1000C0000C000C1
100000000000001
111111111111111