111111111111111011111
1C000000011P0001100001000C1
111011000000000000000000011
1E0000001111100111001110001
111C000000C11000C1000100001
10001001100000000
100011111111111110000000001
1000000011100011001010011C1
111111111111111111111111111