111111
11C111
1E0C11
1P0011
111111