111111111111111
10000100C0000C1
101C0000C000001
111111111110001
1000000C0000001
1000C1000C000C1
100000000000001
111111111111111