111111111111111
1111111CEP11111
111111111111111