111111111111111
1E1C1000C0011C1
1CC01100000P001
110011111110101
1001100C011C001
1000C000C1111C1
1C110000000P001
111111111111111
