111111111111111
101010000001101
10001100000P001
110011111110101
100110000110001
100000000111101
1C1100000000001
101111111111111
101111111111111
1C0000000000101
1EC000000000101
1CS0000000000001
111111111111111